111111111
101000001
100100001
100000001
100000001
100100001
10000T001
100000001
101000001
100000001
100010001
110010001
101000001
111111111